########################
#.......................
#.....####..............
#.....#..#..............
#.....#..#..............
#.....####..............
#.......................
#.......................
#.......................
#.......................
#.......................
#.......................
########################