#########################
|||||||||||||||||||||||||
|||||||||||||||||||||||||
|||||||||||||||||||||||||
#########################
|||||||||||||||||||||||||
|||||||||||||||||||||||||
|||||||||||||||||||||||||
#########################
|||||||||||||||||||||||||
|||||||||||||||||||||||||
|||||||||||||||||||||||||
#########################
|||||||||||||||||||||||||
|||||||||||||||||||||||||
|||||||||||||||||||||||||
#########################
|||||||||||||||||||||||||
*************************