........................
#.......................
#.......................
#.......................
#.......................
#.......................
#.......................
#.......................
#.......................
#.......................
#.......................
#.......................
#.......................
#.......................
########################